0000000000000
0011110111100
0010111111110
0011110101110
0010011101110
0011111111110
0010111111010
0011111011010
0011011111110
1111111110010
0001111111110
0000000000000
0000000000000
