0000000000000
0001111111000
0011100101000
0011111111100
0011111101100
0001111111100
0011111110100
0011100010100
0011111111100
0000000010100
0211111111100
0000000000000
0000000000000
