0000000000000
0110000000000
0111100000000
0111111000000
0111111110000
0111111111100
0111111111110
0111111111000
0111111100000
0111110000000
0111000000000
1100000000000
0000000000000
