0000000000000
0001110111100
0011111111110
0011110101010
0011111111110
0011111101110
0010111111100
0011111111110
0000011111110
1111111111000
0000011110000
0000000000000
0000000000000
