0000000000000
0111110111110
0100010100010
0100010100010
0100010100010
0111111111110
0000010100000
0111110111110
0100000000010
0100000000010
0211111111110
0000000000000
0000000000000
