0000000000000
0111111110000
0100011111100
0100111111110
0111100011010
0101101111010
0101001010010
0101001010010
0101001010010
0111111010010
0111111011010
1110000001110
0000000000000
