0000000000000
0001110001100
0011111001100
0110011111110
0110011000110
0111111111100
0110010000100
0111111100110
1111100100110
0010111111110
0011111111110
0000011110000
0000000000000
