0000000000000
0000000000000
0011111111100
0010000000100
0010000000100
0010011111100
0010010000100
0010010000100
0010010000100
0010010000100
0020011111100
0000000000000
0000000000000
