0000000000000
0001111001110
0011111111000
0111010001000
0111111011110
0101010011010
0111111111010
0001010011010
0111111111010
0101011110010
0101010000010
0211111111110
0000000000000
