0000000000000
0000000000000
0101111111110
0111111111110
0100000000010
0100000000010
0100000000010
0100000001110
0100000011000
0100000011110
0100000000010
1111111111110
0000000000000
