0000000000000
0101111110000
0101000110000
0101000110000
0101000111110
0101000000010
0111111110110
0100000010100
0100000010110
0111111110110
0100000000110
1111111111110
0000000000000
