0000000000000
0000000000000
0011000111000
0011111111100
0011100111110
0011111011110
0011101011110
0010111010110
0011011011110
0021100011010
0001100001110
0000000000000
0000000000000
