0000000000000
0000000000000
0011111111100
0010000000100
0010000000100
0010000000100
0010000000100
0010000000100
0010000000100
0010000000100
0021111111100
0000000000000
0000000000000
