0000000000000
0000000000000
0011111101100
0010011111100
0011111001100
0001111111100
0011001100100
0011101110100
0010111110100
0021110111100
0000000000000
0000000000000
0000000000000
