0000000000000
0000000000000
0000001100000
0000001100000
0000111111000
0001111111100
0001110111110
0001110101110
0011111101110
0011011111110
0011111111110
0211111110110
0000000000000
